9 9 9 9 9 9 9 9 9 9 9 9 9 9 9 9 9 9 9 9 9 9 9 9 9 9 9 9 9 9 9 9 9 9 9 9 9 9 9 9 9 9 9 9 9 9 9 9 9 9 9 9 9 9 9 9 9 9 9 9 9 9 9 9 9 9 9 9 9 9 9 9 9 9 9 9 9 9 9 9 9 9 9 9 9 9 9 9 9 9 9 9 9 9 9 9 9 9 9 9
9 1 1 1 1 1 1 1 1 1 0 0 0 0 0 0 0 0 0 0 0 0 0 0 0 0 0 0 0 0 0 0 0 0 0 0 0 0 0 0 0 0 0 0 0 0 0 0 0 0 0 0 0 0 0 0 0 0 0 0 0 0 0 0 0 0 0 0 0 0 0 0 0 0 0 0 0 0 0 0 0 0 0 0 0 0 0 0 0 0 0 0 0 0 0 0 0 0 0 9
9 1 1 1 1 1 1 1 1 1 0 0 0 0 0 0 0 0 0 0 0 0 0 0 0 0 0 0 0 0 0 0 0 0 0 0 0 0 0 0 0 0 0 0 0 0 0 0 0 0 0 0 0 0 0 0 0 0 0 0 0 0 0 0 0 0 0 0 0 0 0 0 0 0 0 0 0 0 0 0 0 0 0 0 0 0 0 0 0 0 0 0 0 0 0 0 0 0 0 9
9 1 1 1 1 1 1 1 1 1 0 0 0 0 0 0 0 0 0 0 0 0 0 0 0 0 0 0 0 0 0 0 0 0 0 0 0 0 0 0 0 0 0 0 0 0 0 0 0 0 0 0 0 0 0 0 0 0 0 0 0 0 0 0 0 0 0 0 0 0 0 0 0 0 0 0 0 0 0 0 0 0 0 0 0 0 0 0 0 0 0 0 0 0 0 0 0 0 0 9
9 1 1 1 1 1 1 1 1 1 0 0 0 0 0 0 0 0 0 0 0 0 0 0 0 0 0 0 0 0 0 0 0 0 0 0 0 0 0 0 0 0 0 0 0 0 0 0 0 0 0 0 0 0 0 0 0 0 0 0 0 0 0 0 0 0 0 0 0 0 0 0 0 0 0 0 0 0 0 0 0 0 0 0 0 0 0 0 0 0 0 0 0 0 0 0 0 0 0 9
9 1 1 1 1 1 1 1 1 1 0 0 0 0 0 0 0 0 0 0 0 0 0 0 0 0 0 0 0 0 0 0 0 0 0 0 0 0 0 0 0 0 0 0 0 0 0 0 0 0 0 0 0 0 0 0 0 0 0 0 0 0 0 0 0 0 0 0 0 0 0 0 0 0 0 0 0 0 0 0 0 0 0 0 0 0 0 0 0 0 0 0 0 0 0 0 0 0 0 9 
9 1 1 1 1 1 1 1 1 1 0 0 0 0 0 0 0 0 0 0 0 0 0 0 0 0 0 0 0 0 0 0 0 0 0 0 0 0 0 0 0 0 0 0 0 0 0 0 0 0 0 0 0 0 0 0 0 0 0 0 0 0 0 0 0 0 0 0 0 0 0 0 0 0 0 0 0 0 0 0 0 0 0 0 0 0 0 0 0 0 0 0 0 0 0 0 0 0 0 9
9 1 1 1 1 1 1 1 1 1 0 0 0 0 0 0 0 0 0 0 0 0 0 0 0 0 0 0 0 0 0 0 0 0 0 0 0 0 0 0 0 0 0 0 0 0 0 0 0 0 0 0 0 0 0 0 0 0 0 0 0 0 0 0 0 0 0 0 0 0 0 0 0 0 0 0 0 0 0 0 0 0 0 0 0 0 0 0 0 0 0 0 0 0 0 0 0 0 0 9
9 1 1 1 1 1 1 1 1 1 2 2 2 2 2 2 2 2 2 2 2 2 2 2 2 2 2 2 2 2 2 2 2 2 2 2 2 2 2 2 2 2 2 2 2 2 2 2 2 2 2 2 2 2 2 2 2 2 2 2 2 2 2 2 2 2 2 2 2 2 2 2 2 2 2 2 2 2 2 2 2 2 2 2 2 2 2 2 2 2 2 2 2 0 0 0 0 0 0 9
9 1 1 1 1 1 1 1 1 1 2 2 2 2 2 2 2 2 2 2 2 2 2 2 2 2 2 2 2 2 2 2 2 2 2 2 2 2 2 2 2 2 2 2 2 2 2 2 2 2 2 2 2 2 2 2 2 2 2 2 2 2 2 2 2 2 2 2 2 2 2 2 2 2 2 2 2 2 2 2 2 2 2 2 2 2 2 2 2 2 2 2 2 0 0 0 0 0 0 9
9 1 1 1 1 1 1 1 1 1 2 2 2 4 4 4 4 4 4 4 4 4 4 4 4 4 4 4 4 4 4 4 4 4 4 4 4 4 4 4 4 4 4 4 4 4 4 4 4 4 4 4 4 4 4 4 4 4 4 4 4 4 4 4 4 4 4 4 4 4 4 4 4 4 4 4 4 4 4 4 4 4 4 4 4 4 4 4 4 4 4 2 2 0 0 0 0 0 0 9
9 1 1 1 1 1 1 1 1 1 2 2 2 4 5 5 5 5 4 5 5 5 5 4 5 5 5 5 4 5 5 5 5 4 5 5 5 5 4 5 5 5 5 4 5 5 5 5 4 5 5 5 5 4 5 5 5 5 4 5 5 5 5 4 5 5 5 5 4 5 5 5 5 4 5 5 5 5 4 5 5 5 5 4 5 5 5 5 5 5 4 2 2 0 0 0 0 0 0 9
9 1 1 1 1 1 1 1 1 1 2 2 2 4 5 4 5 5 4 5 4 5 5 4 5 4 5 5 4 5 4 5 5 4 5 4 5 5 4 5 4 5 5 4 5 4 5 5 4 5 4 5 5 4 5 4 5 5 4 5 4 5 5 4 5 4 5 5 4 5 4 5 5 4 5 4 5 5 4 5 4 5 5 4 5 5 5 4 5 5 4 2 2 0 0 0 0 0 0 9
9 1 1 1 1 1 1 1 1 1 2 2 2 4 5 4 5 5 4 4 4 5 4 4 4 4 5 4 4 4 4 5 4 4 4 4 5 4 4 4 4 5 4 4 4 4 5 4 4 4 4 5 4 4 4 4 5 4 4 4 4 5 4 4 4 4 5 4 4 4 4 5 4 4 4 4 5 4 4 4 4 5 4 4 4 5 4 4 4 4 4 2 2 0 0 0 0 0 0 9
9 1 1 1 1 1 1 1 1 1 2 2 2 4 5 4 4 4 4 5 5 5 5 5 5 5 5 5 5 5 5 5 5 5 5 5 5 5 5 5 5 5 5 5 5 5 5 5 5 5 5 5 5 5 5 5 5 5 5 5 5 5 5 5 5 5 5 5 5 5 5 5 5 5 5 5 5 5 5 5 5 5 5 5 5 5 5 4 5 5 4 2 2 0 0 0 0 0 0 9
9 1 1 1 1 1 1 1 1 1 2 2 2 4 5 5 5 5 4 5 5 5 5 5 5 5 5 5 5 5 5 5 5 5 5 5 5 5 5 5 5 5 5 5 5 5 5 5 5 5 5 5 5 5 5 5 5 5 5 5 5 5 5 5 5 5 5 5 5 5 5 5 5 5 5 5 5 5 5 5 5 5 5 5 5 5 5 5 5 5 4 2 2 0 0 0 0 0 0 9
9 1 1 1 1 1 1 1 1 1 2 2 2 4 5 5 5 5 5 5 5 5 4 4 4 4 4 4 4 5 5 4 4 4 4 4 4 4 4 4 4 5 5 4 4 4 4 4 4 4 4 4 4 4 4 4 5 5 4 4 4 4 4 4 4 4 4 4 4 4 4 4 4 5 4 4 4 4 4 4 4 4 4 4 4 5 5 4 4 5 4 2 2 0 0 0 0 0 0 9
9 1 1 1 1 1 1 1 1 1 2 2 2 4 4 4 4 4 4 5 5 5 4 5 5 5 5 5 5 5 5 5 5 5 5 5 5 5 5 5 5 5 5 5 5 5 5 5 5 5 5 5 5 5 5 5 5 5 5 5 5 5 5 5 5 5 5 5 5 5 5 5 5 5 5 5 5 5 5 5 5 5 5 5 4 5 5 4 5 5 4 2 2 0 0 0 0 0 0 9
9 1 1 1 1 1 1 1 1 1 2 2 2 4 5 5 5 5 4 5 5 5 4 5 5 5 5 5 5 5 5 5 5 5 5 5 5 5 5 5 5 5 5 5 5 5 5 5 5 5 5 5 5 5 5 5 5 5 5 5 5 5 5 5 5 5 5 5 5 5 5 5 5 5 5 5 5 5 5 5 5 5 5 5 4 5 5 4 5 4 4 2 2 0 0 0 0 0 0 9
9 1 1 1 1 1 1 1 1 1 2 2 2 4 5 5 4 4 4 5 5 5 5 5 5 5 4 4 4 4 4 4 4 4 4 4 4 4 4 4 4 4 4 4 4 4 4 4 4 4 4 4 4 4 4 4 4 4 4 4 4 4 4 4 4 4 4 4 4 4 4 4 4 4 4 4 4 4 4 4 5 5 5 5 4 5 5 4 5 5 4 2 2 0 0 0 0 0 0 9
9 1 1 1 1 1 1 1 1 1 2 2 2 4 5 5 5 5 5 5 5 5 4 5 5 5 4 5 5 4 5 5 5 5 5 5 5 5 5 4 5 5 5 4 5 5 5 5 5 5 5 5 5 5 4 5 5 5 5 5 5 5 5 5 5 5 5 5 5 5 5 5 5 5 5 5 5 5 5 4 5 5 5 5 5 5 5 4 4 4 4 2 2 0 0 0 0 0 0 9
9 1 1 1 1 1 1 1 1 1 2 2 2 4 5 5 5 5 4 5 5 5 4 5 5 5 5 5 5 4 5 5 5 5 5 5 5 5 5 4 5 5 5 4 5 5 5 5 5 5 5 5 5 5 4 5 5 5 5 5 5 5 5 5 5 5 5 5 5 5 5 5 5 5 5 5 5 5 5 4 5 5 5 5 5 5 5 4 5 5 4 2 2 0 0 0 0 0 0 9
9 1 1 1 1 1 1 1 1 1 2 2 2 4 4 4 4 4 4 5 5 5 4 5 5 5 5 5 5 4 4 4 5 5 4 4 4 4 4 4 5 5 5 4 4 4 5 5 4 4 4 4 4 4 4 5 5 5 5 4 4 4 4 4 4 4 5 5 4 4 4 4 4 4 4 4 5 5 5 4 5 5 5 5 4 5 5 5 5 5 4 2 2 0 0 0 0 0 0 9
9 1 1 1 1 1 1 1 1 1 2 2 2 4 5 5 5 5 4 5 5 5 5 5 5 5 4 5 5 5 5 5 5 5 5 5 5 5 5 5 5 5 5 5 5 5 5 5 5 5 5 5 5 5 5 5 5 5 5 4 5 5 5 5 5 5 5 5 5 5 5 5 5 5 5 4 5 5 5 4 5 5 5 5 4 5 5 4 4 5 4 2 2 0 0 0 0 0 0 9
9 1 1 1 1 1 1 1 1 1 2 2 2 4 5 5 4 4 4 5 5 5 5 5 5 5 4 5 5 5 5 5 5 5 5 5 5 5 5 5 5 5 5 5 5 5 5 5 5 5 5 5 5 5 5 5 5 5 5 5 5 5 5 5 5 5 5 5 5 5 5 5 5 5 5 4 5 5 5 4 5 5 5 5 4 5 5 4 5 5 4 2 2 0 0 0 0 0 0 9
9 1 1 1 1 1 1 1 1 1 2 2 2 4 5 5 5 5 5 5 5 5 4 5 5 5 4 4 4 4 4 4 4 4 4 4 4 4 4 4 4 4 4 4 4 4 4 4 4 4 4 4 4 4 4 5 5 5 5 5 5 5 5 5 5 5 5 5 5 5 5 5 5 5 5 4 5 5 5 4 5 5 5 5 4 5 5 4 4 4 4 2 2 0 0 0 0 0 0 9
9 1 1 1 1 1 1 1 1 1 2 2 2 4 5 5 5 5 4 5 5 5 4 5 5 5 5 5 5 5 5 5 5 5 5 5 5 5 5 5 5 5 5 5 5 5 5 5 5 5 5 5 5 5 4 5 5 5 5 4 5 5 5 5 5 5 5 5 5 5 5 5 5 5 5 5 5 5 5 4 5 5 5 5 4 5 5 4 5 5 4 2 2 0 0 0 0 0 0 9
9 1 1 1 1 1 1 1 1 1 2 2 2 4 4 4 4 4 4 4 5 5 4 5 5 5 5 5 5 5 5 5 5 5 5 5 5 5 5 5 5 5 5 5 5 5 5 5 5 5 5 5 5 5 4 5 5 5 5 4 5 5 5 5 5 5 5 5 5 5 5 5 5 5 5 5 5 5 5 4 5 5 5 5 4 5 5 5 5 5 4 2 2 0 0 0 0 0 0 9
9 1 1 1 1 1 1 1 1 1 2 2 2 2 2 2 4 5 5 4 5 5 4 5 5 5 5 5 5 5 5 5 5 5 5 5 5 5 5 5 5 5 5 5 5 5 5 5 5 5 5 5 5 5 4 5 5 5 5 4 5 5 5 5 5 5 5 5 5 5 5 5 5 5 5 4 5 5 5 4 5 5 5 5 4 5 5 4 4 5 4 2 2 0 0 0 0 0 0 9
9 1 1 1 1 1 1 1 1 1 2 2 2 2 2 2 4 5 5 4 5 5 4 5 5 5 5 5 5 5 5 5 5 5 5 5 5 5 5 5 5 5 5 5 5 5 5 5 5 5 5 5 5 5 4 5 5 5 5 4 5 5 5 5 5 5 5 5 5 5 5 5 5 5 5 4 5 5 5 4 5 5 5 5 4 5 5 4 5 5 4 2 2 0 0 0 0 0 0 9
9 1 1 1 1 1 1 1 1 1 2 2 2 2 2 2 4 5 5 4 5 5 4 5 5 5 5 5 5 5 5 5 4 4 4 4 4 4 4 4 4 4 4 5 5 5 5 5 5 5 5 5 5 5 4 5 5 5 5 5 5 5 5 5 5 5 5 5 5 5 5 5 5 5 5 4 5 5 5 4 5 5 5 5 4 5 5 4 4 4 4 2 2 0 0 0 0 0 0 9
9 1 1 1 1 1 1 1 1 1 2 2 2 2 2 2 4 5 5 4 5 5 4 5 5 5 5 5 5 5 5 5 4 5 5 5 5 4 5 5 5 5 4 4 4 4 4 4 4 4 4 5 5 5 4 5 5 5 5 5 5 5 5 5 5 5 5 5 5 5 5 5 5 5 5 4 5 5 5 4 5 5 5 5 4 5 5 4 5 5 4 2 2 0 0 0 0 0 0 9
9 1 1 1 1 1 1 1 1 1 2 2 2 2 2 2 4 5 5 4 5 5 4 5 5 5 5 5 5 5 5 5 4 5 5 5 5 4 5 5 5 5 5 5 5 5 5 5 5 5 4 5 5 5 4 5 5 5 5 4 5 5 5 5 5 5 5 5 5 5 5 5 5 5 5 4 5 5 5 4 5 5 5 5 4 5 5 5 5 5 4 2 2 0 0 0 0 0 0 9
9 1 1 1 1 1 1 1 1 1 0 0 0 2 2 2 4 5 5 4 5 4 4 4 5 5 4 4 5 5 5 5 4 5 5 5 5 4 5 5 5 5 5 5 5 5 5 5 5 5 4 5 5 5 4 5 5 5 5 4 5 5 5 5 5 5 5 5 5 5 5 5 5 5 5 4 5 5 5 4 5 5 5 5 5 5 5 4 4 5 4 2 2 0 0 0 0 0 0 9
9 1 1 1 1 1 1 1 1 1 0 0 0 2 2 2 4 5 5 4 5 4 5 5 5 5 5 4 5 5 5 5 4 5 5 5 5 4 5 5 5 5 4 4 5 4 4 5 5 5 4 5 5 5 4 5 5 5 5 4 5 5 5 5 5 5 5 5 5 5 5 5 5 5 5 4 5 5 5 4 5 5 5 5 5 5 5 4 5 5 4 2 2 0 0 0 0 0 0 9
9 1 1 1 1 1 1 1 1 1 0 0 0 2 2 2 4 5 5 4 4 4 5 5 5 5 5 4 5 5 5 5 4 5 5 5 5 4 5 5 5 5 4 5 5 5 4 5 5 4 4 5 5 5 4 5 5 5 5 4 5 5 5 5 5 5 5 5 5 5 5 5 5 5 5 5 5 5 5 4 5 5 5 5 4 5 5 4 4 4 4 2 2 0 0 0 0 0 0 9
9 1 1 1 1 1 1 1 1 1 0 0 0 2 2 2 4 5 5 5 5 4 5 5 5 5 5 4 5 5 5 5 4 5 5 4 4 4 4 4 5 5 4 5 5 5 4 5 5 5 4 5 5 5 4 5 5 5 5 4 5 5 5 5 5 5 5 5 5 5 5 5 5 5 5 5 5 5 5 4 5 5 5 5 4 5 5 4 5 5 4 2 2 0 0 0 0 0 0 9
9 1 1 1 1 1 1 1 1 1 1 1 1 2 2 2 4 5 5 5 5 4 5 5 5 5 5 4 5 5 5 5 4 5 5 5 5 4 5 5 5 5 4 5 5 5 4 5 5 5 4 5 5 5 4 5 5 5 5 4 5 5 5 5 5 5 5 5 5 5 5 5 5 5 5 4 5 5 5 4 5 5 5 5 4 5 5 5 5 5 4 2 2 0 0 0 0 0 0 9
9 1 1 1 1 1 1 1 1 1 1 1 1 2 2 2 4 4 4 4 4 4 5 5 5 5 5 4 5 5 5 5 4 5 5 5 5 5 5 5 5 5 4 5 5 5 4 4 5 5 4 5 5 5 4 5 5 5 5 4 5 5 5 5 5 5 5 5 5 5 5 5 5 5 5 4 5 5 5 4 5 5 5 5 4 5 5 4 4 5 4 2 2 0 0 0 0 0 0 9
9 1 1 1 1 1 1 1 1 1 1 1 1 2 2 2 2 2 2 2 2 4 5 5 5 5 5 4 5 5 5 5 4 4 4 4 4 4 4 4 4 4 4 5 5 5 4 5 5 5 4 5 5 5 4 5 5 5 5 4 4 4 4 4 4 4 4 5 5 4 4 4 4 4 4 4 5 5 5 4 5 5 5 5 4 5 5 4 5 5 4 2 2 0 0 0 0 0 0 9
9 1 1 1 1 1 1 1 1 1 1 1 1 2 2 2 2 2 2 2 2 4 5 5 5 5 5 4 5 5 5 5 5 5 5 5 5 5 5 5 5 5 5 5 5 5 4 5 5 5 4 5 5 5 4 5 5 5 5 5 5 5 5 5 5 5 5 5 5 5 5 5 5 5 5 5 5 5 5 4 5 5 5 5 4 5 5 4 4 4 4 2 2 0 0 0 0 0 0 9
9 1 1 1 1 1 1 1 1 1 1 1 1 2 2 2 2 2 2 2 2 4 4 4 4 4 4 4 5 5 5 5 5 5 5 5 5 5 5 5 5 5 5 5 5 5 4 4 4 4 4 5 5 5 4 5 5 5 5 5 5 5 5 5 5 5 5 5 5 5 5 5 5 5 5 5 5 5 5 4 5 5 5 5 4 5 5 4 5 5 4 2 2 0 0 0 0 0 0 9
9 1 1 1 1 1 1 1 1 1 1 1 1 2 2 2 2 2 2 2 2 5 5 5 5 5 5 5 5 5 5 5 5 5 5 5 5 5 5 5 5 5 5 5 5 5 5 5 5 5 5 5 5 5 4 4 4 4 4 4 4 4 4 4 4 4 4 4 4 4 4 4 4 4 4 4 4 4 4 4 5 5 5 5 4 5 5 5 5 5 4 2 2 0 0 0 0 0 0 9
9 1 1 1 1 1 1 1 1 1 1 1 1 2 2 2 2 2 2 2 2 5 5 5 5 5 5 5 5 5 5 5 5 5 5 5 5 5 5 5 5 5 5 5 5 5 5 5 5 5 5 5 5 5 5 5 5 5 5 5 5 5 5 4 5 5 5 5 4 5 5 5 5 5 5 5 5 5 5 5 5 5 5 5 4 5 5 4 4 5 4 2 2 0 0 0 0 0 0 9
9 1 1 1 1 1 1 1 1 1 1 1 1 2 2 2 2 2 2 2 2 5 5 5 5 5 5 5 5 5 5 5 5 5 5 5 5 5 5 5 5 5 5 5 5 5 5 5 5 5 5 5 5 5 5 5 5 5 5 5 5 5 5 5 5 5 5 5 5 5 5 5 5 5 5 5 5 5 5 5 5 5 5 5 5 5 5 4 5 5 4 2 2 0 0 0 0 0 0 9
9 1 1 1 1 1 1 1 1 1 1 1 1 2 2 2 2 2 2 2 2 5 5 5 5 5 5 5 5 5 5 5 5 5 5 5 5 5 5 5 5 5 5 5 5 5 5 5 5 5 5 5 5 5 5 5 5 5 5 5 5 5 5 5 5 5 5 5 5 5 5 5 5 5 5 5 5 5 5 5 5 5 5 5 5 5 5 4 4 4 4 2 2 0 0 0 0 0 0 9
9 1 1 1 1 1 1 1 1 1 1 1 1 2 2 2 2 2 2 2 2 5 5 5 5 5 5 5 5 5 5 5 5 5 5 5 5 5 5 5 5 5 5 5 5 5 5 5 5 5 5 5 5 5 5 5 5 5 5 5 5 5 5 4 5 5 5 5 4 5 5 5 5 5 5 5 5 5 5 5 5 5 5 5 4 5 5 4 5 5 4 2 2 0 0 0 0 0 0 9
9 1 1 1 1 1 1 1 1 1 1 1 1 2 2 2 2 2 2 2 2 5 5 5 5 5 5 5 5 5 5 5 5 5 5 5 5 5 5 5 5 5 5 5 5 5 5 5 5 5 5 5 5 5 4 4 4 4 4 4 4 4 4 4 4 4 4 4 4 4 4 4 4 4 4 4 4 4 4 4 5 5 5 5 4 5 5 5 5 5 4 2 2 0 0 0 0 0 0 9
9 1 1 1 1 1 1 1 1 1 1 1 1 2 2 2 2 2 2 2 2 4 5 5 5 5 5 5 5 5 5 5 5 5 5 5 5 5 5 5 5 5 5 5 5 5 5 5 5 5 5 5 5 5 4 5 5 4 5 5 4 5 5 5 4 5 5 4 5 5 4 5 5 4 5 5 4 5 5 4 5 5 5 5 4 5 5 4 4 5 4 2 2 0 0 0 0 0 0 9
9 1 1 1 1 1 1 1 1 1 1 1 1 2 2 2 2 2 2 2 2 4 5 5 5 5 5 5 5 5 5 5 4 4 4 4 4 4 4 4 4 5 5 4 4 4 4 4 4 4 4 4 5 5 4 5 5 4 5 5 4 5 5 5 5 5 5 5 5 5 4 5 5 4 5 5 4 5 5 4 5 5 5 5 4 5 5 4 5 5 4 2 2 0 0 0 0 0 0 9
9 1 1 1 1 1 1 1 1 1 1 1 1 2 2 2 2 2 2 2 2 4 5 5 5 5 5 5 5 5 5 5 4 5 5 5 5 5 5 5 5 5 5 5 5 5 5 5 5 5 5 4 5 5 4 5 5 4 5 5 4 5 5 5 5 5 5 5 5 5 4 5 5 4 5 5 4 5 5 4 5 5 5 5 4 5 5 4 4 4 4 2 2 0 0 0 0 0 0 9
9 1 1 1 1 1 1 1 1 1 1 1 1 2 2 2 4 4 4 4 4 4 4 4 4 4 4 4 5 5 5 5 4 5 5 5 5 5 5 5 4 5 5 4 5 5 5 5 5 5 5 4 5 5 4 5 5 5 5 5 5 5 5 5 4 5 5 4 5 5 5 5 5 5 5 5 5 5 5 4 5 5 5 5 4 5 5 4 5 5 4 2 2 0 0 0 0 0 0 9
9 1 1 1 1 1 1 1 1 1 1 1 1 2 2 2 4 5 4 5 5 5 5 5 4 5 5 4 5 5 5 5 4 5 5 4 4 4 5 4 4 4 4 4 5 5 5 5 5 5 5 4 5 5 4 5 5 5 5 5 5 5 5 5 4 5 5 4 5 5 5 5 5 5 5 5 5 5 5 4 5 5 5 5 4 5 5 5 5 5 4 2 2 0 0 0 0 0 0 9 
9 1 1 1 1 1 1 1 1 1 0 0 0 2 2 2 4 5 4 4 5 5 4 5 5 5 5 4 5 5 5 5 4 5 5 4 5 5 5 5 5 5 5 5 5 5 5 5 5 5 5 4 4 5 4 4 4 4 5 5 5 4 4 4 4 5 5 4 4 4 4 4 5 5 5 4 4 4 4 4 5 5 5 5 4 5 5 4 4 5 4 2 2 0 0 0 0 0 0 9
9 1 1 1 1 1 1 1 1 1 0 0 0 2 2 2 4 5 5 4 4 4 4 4 4 5 4 4 5 5 5 5 4 5 5 4 5 5 5 5 5 5 5 5 5 5 5 5 5 5 5 4 5 5 5 5 5 5 5 5 5 5 5 5 5 5 5 5 5 5 5 5 5 5 5 5 5 5 5 4 5 5 5 5 5 5 5 4 5 5 4 2 2 0 0 0 0 0 0 9
9 1 1 1 1 1 1 1 1 1 0 0 0 2 2 2 4 5 5 4 5 5 5 5 5 5 5 4 5 5 5 5 4 5 5 4 4 4 5 4 4 4 4 4 5 5 5 5 5 5 5 4 5 5 5 5 5 5 5 5 5 5 5 5 5 5 5 5 5 5 5 5 5 5 5 5 5 5 5 4 5 5 5 5 5 5 5 4 4 4 4 2 2 0 0 0 0 0 0 9
9 1 1 1 1 1 1 1 1 1 0 0 0 2 2 2 4 5 5 5 5 5 5 5 5 5 5 4 5 5 5 5 4 5 5 5 5 5 5 5 4 5 5 4 5 5 5 5 5 5 5 4 4 5 4 4 4 4 5 5 5 4 4 4 4 5 5 4 4 4 4 4 5 5 5 4 4 4 4 4 5 5 5 5 4 5 5 4 5 5 4 2 2 0 0 0 0 0 0 9
9 1 1 1 1 1 1 1 1 1 2 2 2 2 2 2 4 4 4 4 5 5 4 4 4 4 4 4 5 5 5 5 4 4 4 4 4 5 4 4 4 5 5 4 4 4 4 5 5 4 4 4 5 5 4 5 5 5 5 5 5 5 5 5 4 5 5 4 5 5 5 5 5 5 5 5 5 5 5 4 5 5 5 5 4 5 5 5 5 5 4 2 2 0 0 0 0 0 0 9
9 1 1 1 1 1 1 1 1 1 2 2 2 2 2 2 4 5 5 4 5 5 4 5 5 5 5 5 5 5 5 5 5 5 5 5 5 5 5 5 5 5 5 5 5 5 4 5 5 4 5 5 5 5 4 5 5 5 5 5 5 5 5 5 4 5 5 4 5 5 5 5 5 5 5 5 5 5 5 4 5 5 5 5 4 5 5 4 4 5 4 2 2 0 0 0 0 0 0 9
9 1 1 1 1 1 1 1 1 1 2 2 2 2 2 2 4 5 5 5 5 5 5 5 5 5 5 5 5 5 5 5 5 5 5 5 5 5 5 5 5 5 5 5 5 5 4 5 5 4 5 5 5 5 4 4 4 4 5 5 5 4 4 4 4 5 5 4 4 4 4 4 4 4 4 4 5 5 5 4 5 5 5 5 4 5 5 4 5 5 4 2 2 0 0 0 0 0 0 9
9 1 1 1 1 1 1 1 1 1 2 2 2 2 2 2 4 5 4 4 5 5 4 5 5 5 5 5 5 5 5 5 5 5 5 5 5 5 5 5 5 5 5 5 5 5 5 5 5 5 5 5 5 5 4 5 5 5 5 4 5 5 5 5 4 5 5 4 5 5 4 5 5 5 5 4 5 5 5 4 5 5 5 5 4 5 5 4 4 4 4 2 2 0 0 0 0 0 0 9
9 1 1 1 1 1 1 1 1 1 2 2 2 2 2 2 4 5 5 4 5 5 4 5 5 5 5 5 5 5 5 5 5 5 5 5 5 5 5 5 5 5 5 5 5 5 4 5 5 4 5 5 5 5 4 5 5 5 5 4 5 5 5 5 4 5 5 4 5 5 4 5 5 5 5 4 5 5 5 4 5 5 5 5 4 5 5 4 5 5 4 2 2 0 0 0 0 0 0 9
9 1 1 1 1 1 1 1 1 1 2 2 2 4 4 4 4 4 4 5 5 5 4 5 5 5 4 4 4 4 4 4 4 4 4 4 4 5 4 4 4 4 4 4 4 4 4 5 5 4 4 4 4 4 4 4 4 4 5 4 5 5 5 5 4 5 5 4 5 5 4 4 4 5 5 4 5 5 5 4 5 5 5 5 4 5 5 5 5 5 4 2 2 0 0 0 0 0 0 9
9 1 1 1 1 1 1 1 1 1 2 2 2 4 5 5 5 5 4 5 5 5 4 5 5 5 4 5 5 5 4 5 5 5 4 5 5 5 4 5 5 5 4 5 5 5 5 5 5 5 5 5 5 5 5 5 5 5 5 4 5 5 5 5 4 5 5 4 5 5 5 5 5 5 5 4 5 5 5 4 5 5 5 5 4 5 5 4 4 5 4 2 2 0 0 0 0 0 0 9
9 1 1 1 1 1 1 1 1 1 2 2 2 4 5 5 5 5 5 5 5 5 4 5 5 5 4 5 5 5 4 5 5 5 5 5 5 5 5 5 5 5 5 5 5 5 5 5 5 5 5 5 5 5 5 5 5 5 5 4 4 4 4 4 4 5 5 4 5 5 5 5 5 5 5 4 5 5 5 4 5 5 5 5 5 5 5 4 5 5 4 2 2 0 0 0 0 0 0 9
9 1 1 1 1 1 1 1 1 1 2 2 2 4 5 5 4 4 4 5 5 5 5 5 5 5 4 5 5 5 4 4 4 4 4 4 4 4 4 4 4 4 4 5 5 5 5 4 4 4 4 4 4 4 4 5 5 5 5 5 5 5 5 5 4 5 5 4 5 5 5 4 4 4 4 4 5 5 5 4 5 5 5 5 5 5 5 4 4 4 4 2 2 0 0 0 0 0 0 9
9 1 1 1 1 1 1 1 1 1 2 2 2 4 5 5 4 5 4 5 5 5 5 5 5 5 4 5 5 5 5 5 5 5 5 5 5 5 5 5 4 5 5 5 5 5 5 4 5 5 5 5 5 5 5 5 5 5 5 5 5 5 5 5 5 5 5 4 5 5 5 5 5 5 5 5 5 5 5 4 5 5 5 5 4 5 5 4 5 5 4 2 2 0 0 0 0 0 0 9
9 1 1 1 1 1 1 1 1 1 2 2 2 4 5 5 5 5 4 5 5 5 4 5 5 5 4 5 5 5 5 5 5 5 5 5 5 5 5 5 5 5 5 5 5 5 5 4 5 5 5 5 5 5 4 5 5 5 5 5 5 5 5 5 4 5 5 4 5 5 5 5 5 5 5 5 5 5 5 4 5 5 5 5 4 5 5 5 5 5 4 2 2 0 0 0 0 0 0 9
9 1 1 1 1 1 1 1 1 1 2 2 2 4 4 4 4 4 4 5 5 5 4 5 5 5 4 4 4 4 4 4 4 4 4 4 4 5 4 4 4 4 4 4 5 5 4 4 4 4 4 4 4 4 4 4 4 4 4 4 4 4 4 4 4 5 5 4 4 4 4 4 4 4 4 4 4 4 4 4 5 5 5 5 4 5 5 4 4 5 4 2 2 0 0 0 0 0 0 9
9 1 1 1 1 1 1 1 1 1 2 2 2 4 5 5 5 5 4 5 5 5 4 5 5 5 5 5 5 5 5 5 5 5 5 5 5 5 5 5 5 5 5 5 5 5 5 5 5 5 5 5 5 5 5 5 5 5 5 5 5 5 5 5 5 5 5 5 5 5 5 5 5 5 5 5 5 5 5 5 5 5 5 5 4 5 5 4 5 5 4 2 2 0 0 0 0 0 0 9
9 1 1 1 1 1 1 1 1 1 2 2 2 4 5 5 5 5 5 5 5 5 4 5 5 5 5 5 5 5 5 5 5 5 5 5 5 5 5 5 5 5 5 5 5 5 5 5 5 5 5 5 5 5 5 5 5 5 5 5 5 5 5 5 5 5 5 5 5 5 5 5 5 5 5 5 5 5 5 5 5 5 5 5 4 5 5 4 4 4 4 2 2 0 0 0 0 0 0 9
9 1 1 1 1 1 1 1 1 1 2 2 2 4 5 5 4 4 4 5 5 5 4 5 5 5 5 5 5 5 5 5 5 5 5 5 5 5 5 5 5 5 5 5 5 5 5 5 5 5 5 5 5 5 5 5 5 5 5 5 5 5 5 5 5 5 5 5 5 5 5 5 5 5 5 5 5 5 5 5 5 5 5 5 4 5 5 4 5 5 4 2 2 0 0 0 0 0 0 9
9 1 1 1 1 1 1 1 1 1 2 2 2 4 5 5 4 5 4 5 5 5 4 4 4 4 4 4 4 4 4 4 5 4 4 4 4 4 4 4 4 4 4 4 4 4 4 4 5 5 4 4 4 4 4 4 4 4 4 4 4 4 4 4 4 5 5 4 4 4 4 4 4 4 4 4 4 4 5 4 4 4 4 4 4 5 5 5 5 5 4 2 2 0 0 0 0 0 0 9
9 1 1 1 1 1 1 1 1 1 2 2 2 4 5 5 5 5 4 5 5 5 5 5 5 5 5 5 5 5 5 5 5 5 5 5 5 5 5 5 5 5 5 5 5 5 5 5 5 5 5 5 5 5 5 5 5 5 5 5 5 5 5 5 5 5 5 5 5 5 5 5 5 5 5 5 5 5 5 5 5 5 5 5 5 5 5 4 4 5 4 2 2 0 0 0 0 0 0 9
9 1 1 1 1 1 1 1 1 1 2 2 2 4 4 4 4 4 4 5 5 5 5 5 5 5 5 5 5 5 5 5 5 5 5 5 5 5 5 5 5 5 5 5 5 5 5 5 5 5 5 5 5 5 5 5 5 5 5 5 5 5 5 5 5 5 5 5 5 5 5 5 5 5 5 5 5 5 5 5 5 5 5 5 5 5 5 4 5 5 4 2 2 0 0 0 0 0 0 9
9 1 1 1 1 1 1 1 1 1 2 2 2 4 5 5 5 5 4 5 4 4 4 4 5 4 4 4 4 5 4 4 4 4 5 4 4 4 4 5 4 4 4 4 5 4 4 4 4 5 4 4 4 4 5 4 4 4 4 5 4 4 4 4 5 4 4 4 4 5 4 4 4 4 5 4 4 4 4 5 4 4 4 4 4 5 4 4 4 4 4 2 2 0 0 0 0 0 0 9
9 1 1 1 1 1 1 1 1 1 2 2 2 4 5 5 4 4 4 5 5 4 5 4 5 5 4 5 4 5 5 4 5 4 5 5 4 5 4 5 5 4 5 4 5 5 4 5 4 5 5 4 5 4 5 5 4 5 4 5 5 4 5 4 5 5 4 5 4 5 5 4 5 4 5 5 4 5 4 5 5 4 5 5 4 5 5 5 5 5 4 2 2 0 0 0 0 0 0 9
9 1 1 1 1 1 1 1 1 1 2 2 2 4 5 5 5 5 5 5 5 4 5 5 5 5 4 5 5 5 5 4 5 5 5 5 4 5 5 5 5 4 5 5 5 5 4 5 5 5 5 4 5 5 5 5 4 5 5 5 5 4 5 5 5 5 4 5 5 5 5 4 5 5 5 5 4 5 5 5 5 4 5 5 5 5 5 4 5 5 4 2 2 0 0 0 0 0 0 9
9 1 1 1 1 1 1 1 1 1 2 2 2 4 4 4 4 4 4 4 4 4 4 4 4 4 4 4 4 4 4 4 4 4 4 4 4 4 4 4 4 4 4 4 4 4 4 4 4 4 4 4 4 4 4 4 4 4 4 4 4 4 4 4 4 4 4 4 4 4 4 4 4 4 4 4 4 4 4 4 4 4 4 4 4 4 4 4 4 4 4 2 2 0 0 0 0 0 0 9
9 1 1 1 1 1 1 1 1 1 2 2 2 2 2 2 2 2 2 2 2 2 2 2 2 2 2 2 2 2 2 2 2 2 2 2 2 2 2 2 2 2 2 2 2 2 2 2 2 2 2 2 2 2 2 2 2 2 2 2 2 2 2 2 2 2 2 2 2 2 2 2 2 2 2 2 2 2 2 2 2 2 2 2 2 2 2 2 2 2 2 2 2 0 0 0 0 0 0 9
9 9 9 9 9 9 9 9 9 9 9 9 9 9 9 9 9 9 9 9 9 9 9 9 9 9 9 9 9 9 9 9 9 9 9 9 9 9 9 9 9 9 9 9 9 9 9 9 9 9 9 9 9 9 9 9 9 9 9 9 9 9 9 9 9 9 9 9 9 9 9 9 9 9 9 9 9 9 9 9 9 9 9 9 9 9 9 9 9 9 9 9 9 9 9 9 9 9 9 9 
