9 9 9 9 9 9 9 9 9 9 9 9 9 9 9 9 9 9 9 9 9 9 9 9 9 9 9 9 9 9 9 9 9 9 9 9 9 9 9 9 9 9 9 9 9 9 9 9 9 9 9 9 9 9 9 9 9 9 9 9 9 9 9 9 9 9 9 9 9 9 9 9 9 9 9 9 9 9 9 9 9 9 9 9 9 9 9 9 9 9 9 9 9 9 9 9 9 9 9 9
9 1 1 1 1 1 1 1 1 1 0 0 0 0 0 0 0 0 0 0 0 0 0 0 0 0 0 0 0 0 0 0 0 0 0 0 0 0 0 0 0 0 0 0 0 0 0 0 0 0 0 0 0 0 0 0 0 0 0 0 0 0 0 0 0 0 0 0 0 0 0 0 0 0 0 0 0 0 0 0 0 0 0 0 0 0 0 0 0 0 0 0 0 0 0 0 0 0 0 9
9 1 1 1 1 1 1 1 1 1 0 0 0 0 0 0 0 0 0 0 0 0 0 0 0 0 0 0 0 0 0 0 0 0 0 0 0 0 0 0 0 0 0 0 0 0 0 0 0 0 0 0 0 0 0 0 0 0 0 0 0 0 0 0 0 0 0 0 0 0 0 0 0 0 0 0 0 0 0 0 0 0 0 0 0 0 0 0 0 0 0 0 0 0 0 0 0 0 0 9
9 1 1 1 1 1 1 1 1 1 0 0 0 0 0 0 0 0 0 0 0 0 0 0 0 0 0 0 0 0 0 0 0 0 0 0 0 0 0 0 0 0 0 0 0 0 0 0 0 0 0 0 0 0 0 0 0 0 0 0 0 0 0 0 0 0 0 0 0 0 0 0 0 0 0 0 0 0 0 0 0 0 0 0 0 0 0 0 0 0 0 0 0 0 0 0 0 0 0 9
9 1 1 1 1 1 1 1 1 1 0 0 0 0 0 0 0 0 0 0 0 0 0 0 0 0 0 0 0 0 0 0 0 0 0 0 0 0 0 0 0 0 0 0 0 0 0 0 0 0 0 0 0 0 0 0 0 0 0 0 0 0 0 0 0 0 0 0 0 0 0 0 0 0 0 0 0 0 0 0 0 0 0 0 0 0 0 0 0 0 0 0 0 0 0 0 0 0 0 9
9 1 1 1 1 1 1 1 1 1 0 0 0 0 0 0 0 0 0 0 0 0 0 0 0 0 0 0 0 0 0 0 0 0 0 0 0 0 0 0 0 0 0 0 0 0 0 0 0 0 0 0 0 0 0 0 0 0 0 0 0 0 0 0 0 0 0 0 0 0 0 0 0 0 0 0 0 0 0 0 0 0 0 0 0 0 0 0 0 0 0 0 0 0 0 0 0 0 0 9 
9 1 1 1 1 1 1 1 1 1 0 0 0 0 0 0 0 0 0 0 0 0 0 0 0 0 0 0 0 0 0 0 0 0 0 0 0 0 0 0 0 0 0 0 0 0 0 0 0 0 0 0 0 0 0 0 0 0 0 0 0 0 0 0 0 0 0 0 0 0 0 0 0 0 0 0 0 0 0 0 0 0 0 0 0 0 0 0 0 0 0 0 0 0 0 0 0 0 0 9
9 1 1 1 1 1 1 1 1 1 0 0 0 0 0 0 0 0 0 0 0 0 0 0 0 0 0 0 0 0 0 0 0 0 0 0 0 0 0 0 0 0 0 0 0 0 0 0 0 0 0 0 0 0 0 0 0 0 0 0 0 0 0 0 0 0 0 0 0 0 0 0 0 0 0 0 0 0 0 0 0 0 0 0 0 0 0 0 0 0 0 0 0 0 0 0 0 0 0 9
9 1 1 1 1 1 1 1 1 1 2 2 2 2 2 2 2 2 2 2 2 2 2 2 2 2 2 2 2 2 2 2 2 2 2 2 2 2 2 2 2 2 2 2 2 2 2 2 2 2 2 2 2 2 2 2 2 2 2 2 2 2 2 2 2 2 2 2 2 2 2 2 2 2 2 2 2 2 2 2 2 2 2 2 2 2 2 2 2 2 2 2 2 0 0 0 0 0 0 9
9 1 1 1 1 1 1 1 1 1 2 2 2 2 2 2 2 2 2 2 2 2 2 2 2 2 2 2 2 2 2 2 2 2 2 2 2 2 2 2 2 2 2 2 2 2 2 2 2 2 2 2 2 2 2 2 2 2 2 2 2 2 2 2 2 2 2 2 2 2 2 2 2 2 2 2 2 2 2 2 2 2 2 2 2 2 2 2 2 2 2 2 2 0 0 0 0 0 0 9
9 1 1 1 1 1 1 1 1 1 2 2 2 4 4 4 4 4 4 4 4 4 4 4 4 4 4 4 4 4 4 4 4 4 4 4 4 4 4 4 4 4 4 4 4 4 4 4 4 4 4 4 4 4 4 4 4 4 4 4 4 4 4 4 4 4 4 4 4 4 4 4 4 4 4 4 4 4 4 4 4 4 4 4 4 4 4 4 4 4 4 2 2 0 0 0 0 0 0 9
9 1 1 1 1 1 1 1 1 1 2 2 2 4 5 5 5 5 4 11 5 5 17 4 11 5 5 17 4 11 5 5 17 4 11 5 5 17 11 5 5 5 17 4 11 5 5 17 4 11 5 5 17 4 11 5 5 17 4 11 5 5 17 4 11 5 5 17 4 11 5 5 17 4 11 5 5 17 4 11 5 5 17 4 7 5 5 5 5 11 4 2 2 0 0 0 0 0 0 9
9 1 1 1 1 1 1 1 1 1 2 2 2 4 5 4 5 5 4 10 4 5 5 4 10 4 5 5 4 10 4 5 5 4 10 4 5 5 10 5 4 5 5 4 10 4 5 5 4 10 4 5 5 4 10 4 5 5 4 10 4 5 5 4 10 4 5 5 4 10 4 5 5 4 10 4 5 5 4 10 4 5 5 4 7 5 5 4 5 10 4 2 2 0 0 0 0 0 0 9
9 1 1 1 1 1 1 1 1 1 2 2 2 4 5 4 10 12 4 4 4 30 4 4 4 4 30 4 4 4 4 30 4 4 4 4 30 4 4 4 4 30 4 4 4 4 30 4 4 4 4 30 4 4 4 4 30 4 4 4 4 30 4 4 4 4 30 4 4 4 4 30 4 4 4 4 30 4 4 4 4 30 4 4 4 30 4 4 4 4 4 2 2 0 0 0 0 0 0 9
9 1 1 1 1 1 1 1 1 1 2 2 2 4 5 4 4 4 4 5 5 5 5 5 5 5 5 5 5 5 5 5 5 5 5 5 5 5 5 5 5 5 5 5 5 5 5 5 5 5 5 5 5 5 5 5 5 5 5 5 5 5 5 5 5 5 5 5 5 5 5 5 5 5 5 5 5 5 5 5 5 5 5 5 5 5 5 4 5 15 4 2 2 0 0 0 0 0 0 9
9 1 1 1 1 1 1 1 1 1 2 2 2 4 5 5 5 5 4 5 5 5 5 21 21 21 21 5 5 5 5 5 5 5 21 21 5 21 5 5 5 5 5 5 21 5 5 5 21 21 21 5 5 5 21 5 5 5 5 21 21 21 5 5 5 21 21 5 5 21 21 5 5 5 5 5 21 5 21 5 21 5 21 21 5 5 5 26 5 5 4 2 2 0 0 0 0 0 0 9
9 1 1 1 1 1 1 1 1 1 2 2 2 4 3 3 5 5 28 5 5 5 4 4 4 4 4 4 4 25 25 4 4 4 4 4 4 4 4 4 4 25 25 4 4 4 4 4 4 4 4 4 4 4 4 4 25 25 4 4 4 4 4 4 4 4 4 4 4 4 4 4 4 5 4 4 4 4 4 4 4 4 4 4 4 5 5 4 4 5 4 2 2 0 0 0 0 0 0 9
9 1 1 1 1 1 1 1 1 1 2 2 2 4 4 4 4 4 4 5 5 20 4 5 5 5 5 5 5 5 5 5 5 5 5 5 5 5 5 5 5 5 5 5 5 5 5 5 5 5 5 5 5 5 5 5 5 5 5 5 5 5 5 5 5 5 5 5 5 5 5 5 5 5 5 5 5 5 5 5 5 5 5 5 4 19 5 4 5 5 4 2 2 0 0 0 0 0 0 9
9 1 1 1 1 1 1 1 1 1 2 2 2 4 5 5 10 12 4 5 5 5 4 5 5 5 5 5 5 5 5 5 5 5 5 5 5 5 5 5 5 5 5 5 5 5 5 5 5 5 5 5 5 5 5 5 5 5 5 5 5 5 5 5 5 5 5 5 5 5 5 5 5 5 5 5 5 5 5 5 5 5 5 5 4 19 5 4 5 4 4 2 2 0 0 0 0 0 0 9
9 1 1 1 1 1 1 1 1 1 2 2 2 4 5 5 4 4 4 5 5 5 5 5 5 5 4 4 4 4 4 4 4 4 4 4 4 4 4 4 4 4 4 4 4 4 4 4 4 4 4 4 4 4 4 4 4 4 4 4 4 4 4 4 4 4 4 4 4 4 4 4 4 4 4 4 4 4 4 4 5 5 5 5 4 5 5 4 10 12 4 2 2 0 0 0 0 0 0 9
9 1 1 1 1 1 1 1 1 1 2 2 2 4 5 5 5 5 28 5 5 5 4 5 5 5 4 5 5 4 7 5 5 19 10 10 20 5 5 4 8 8 8 4 8 8 5 5 8 8 5 8 8 5 4 5 5 5 5 5 5 5 5 5 5 5 5 5 5 5 5 5 5 5 5 5 5 5 5 4 5 5 5 5 29 5 5 4 4 4 4 2 2 0 0 0 0 0 0 9
9 1 1 1 1 1 1 1 1 1 2 2 2 4 5 5 3 3 4 5 5 5 4 5 5 5 27 5 5 4 7 5 5 5 5 5 5 5 5 4 5 5 5 4 5 5 5 5 5 5 5 5 5 5 4 5 5 5 5 5 5 5 5 5 5 5 5 5 5 5 5 5 5 5 5 5 5 5 5 4 5 5 5 5 29 5 5 4 5 15 4 2 2 0 0 0 0 0 0 9
9 1 1 1 1 1 1 1 1 1 2 2 2 4 4 4 4 4 4 5 5 20 4 5 5 5 27 5 5 4 4 4 25 25 4 4 4 4 4 4 5 5 5 4 4 4 25 25 4 4 4 4 4 4 4 5 5 5 5 4 4 4 4 4 4 4 25 25 4 4 4 4 4 4 4 4 5 5 5 4 5 5 5 5 4 5 5 26 5 5 4 2 2 0 0 0 0 0 0 9
9 1 1 1 1 1 1 1 1 1 2 2 2 4 5 5 10 12 4 5 5 5 27 5 5 5 4 5 5 5 5 5 5 5 5 5 5 5 5 5 5 5 5 5 5 5 5 5 5 5 5 5 5 5 5 5 5 5 5 4 5 5 5 5 5 5 5 5 5 5 5 5 5 5 5 4 5 5 5 4 5 5 5 5 4 5 5 4 4 5 4 2 2 0 0 0 0 0 0 9
9 1 1 1 1 1 1 1 1 1 2 2 2 4 5 5 4 4 4 5 5 5 27 5 5 5 4 5 5 5 5 5 5 5 5 5 5 5 5 5 5 5 5 5 5 5 5 5 5 5 5 5 5 5 5 5 5 5 5 27 5 5 19 19 5 5 5 5 5 19 19 5 5 5 5 4 5 5 5 4 5 5 5 5 4 19 5 4 10 12 4 2 2 0 0 0 0 0 0 9
9 1 1 1 1 1 1 1 1 1 2 2 2 4 5 5 5 5 28 5 5 5 4 5 5 5 4 4 4 4 4 4 4 4 4 4 4 4 4 4 4 4 4 4 4 4 4 4 4 4 4 4 4 4 4 5 5 5 5 27 5 19 10 10 20 5 5 5 19 10 10 20 5 5 5 4 5 5 5 4 5 5 5 5 4 19 5 4 4 4 4 2 2 0 0 0 0 0 0 9
9 1 1 1 1 1 1 1 1 1 2 2 2 4 5 5 3 3 4 5 5 5 4 5 5 5 5 5 5 19 19 19 19 5 5 5 5 5 5 5 5 5 5 19 19 19 19 19 5 5 5 5 5 5 4 5 5 5 5 4 5 19 10 10 20 5 5 5 19 10 10 20 5 5 5 29 5 5 5 4 5 5 5 5 4 19 5 4 5 15 4 2 2 0 0 0 0 0 0 9
9 1 1 1 1 1 1 1 1 1 2 2 2 4 4 4 4 4 4 4 5 5 4 5 5 5 5 5 5 5 5 5 5 5 5 5 5 5 5 5 5 5 5 5 5 5 5 5 5 5 5 5 5 5 4 5 5 5 5 4 5 19 10 10 20 5 5 5 19 10 10 20 5 5 5 29 5 5 5 4 5 5 5 5 4 5 5 26 5 5 4 2 2 0 0 0 0 0 0 9
9 1 1 1 1 1 1 1 1 1 2 2 2 2 2 2 4 7 5 4 5 5 4 5 5 5 5 5 5 5 5 5 5 5 5 5 5 5 5 5 5 5 5 5 5 5 5 5 5 5 5 5 5 5 4 5 5 5 5 4 5 19 10 10 20 5 5 5 19 10 10 20 5 5 5 4 5 5 5 4 5 5 5 5 4 19 5 4 4 5 4 2 2 0 0 0 0 0 0 9
9 1 1 1 1 1 1 1 1 1 2 2 2 2 2 2 4 7 5 4 5 20 4 5 5 5 5 5 5 5 5 5 5 5 5 5 5 5 5 5 5 5 5 5 5 5 5 5 5 5 5 5 5 5 4 5 5 5 5 4 5 5 21 21 5 5 5 5 5 21 21 5 5 5 5 4 10 20 5 4 5 5 5 5 4 5 5 4 10 12 4 2 2 0 0 0 0 0 0 9
9 1 1 1 1 1 1 1 1 1 2 2 2 2 2 2 4 5 5 4 5 20 4 5 5 5 5 5 5 5 5 5 4 4 4 4 4 4 4 4 4 4 4 5 5 5 5 5 5 5 5 5 5 20 4 5 5 5 5 27 5 5 5 5 5 5 5 5 5 5 5 5 5 5 5 4 10 20 5 4 5 5 5 5 4 19 5 4 4 4 4 2 2 0 0 0 0 0 0 9
9 1 1 1 1 1 1 1 1 1 2 2 2 2 2 2 4 7 5 4 5 5 4 5 5 5 5 5 5 5 5 5 4 5 5 5 15 4 10 5 5 5 4 4 4 4 4 4 4 4 4 5 5 20 4 5 5 5 5 27 5 5 5 5 5 5 5 5 5 5 5 5 5 5 5 4 10 20 5 4 5 5 5 5 4 5 5 4 5 15 4 2 2 0 0 0 0 0 0 9
9 1 1 1 1 1 1 1 1 1 2 2 2 2 2 2 4 7 5 4 5 5 4 5 5 5 5 5 5 5 5 5 4 5 5 5 10 4 10 20 5 5 5 5 5 5 5 5 19 11 4 5 5 20 4 5 5 5 5 4 5 5 19 19 5 5 5 5 5 19 19 5 5 5 5 4 10 20 5 4 5 5 5 5 4 5 5 26 5 5 4 2 2 0 0 0 0 0 0 9
9 1 1 1 1 1 1 1 1 1 0 0 0 2 2 2 4 5 5 4 5 4 4 4 31 31 4 4 5 5 5 5 4 5 5 19 10 4 10 5 5 5 5 5 5 5 5 5 5 11 4 5 5 20 4 5 5 19 10 4 5 19 10 10 20 5 5 5 19 10 10 20 5 5 5 4 10 20 5 4 5 5 5 5 29 5 5 4 4 5 4 2 2 0 0 0 0 0 0 9
9 1 1 1 1 1 1 1 1 1 0 0 0 2 2 2 4 5 5 4 5 4 15 5 5 5 5 4 5 5 5 5 4 5 5 5 10 4 5 5 5 5 4 4 5 4 4 5 5 5 4 5 5 20 4 5 5 19 10 4 5 19 10 10 20 5 5 5 19 10 10 20 5 5 5 4 5 5 5 4 5 5 5 5 29 5 5 4 10 12 4 2 2 0 0 0 0 0 0 9
9 1 1 1 1 1 1 1 1 1 0 0 0 2 2 2 4 7 5 4 4 4 5 5 5 5 10 4 5 5 5 11 4 5 5 5 5 4 15 5 5 5 4 5 5 5 4 5 5 4 4 5 5 5 4 5 5 19 10 4 5 19 10 10 20 5 5 5 19 10 10 20 5 5 5 29 5 5 5 4 5 5 5 5 4 5 5 4 4 4 4 2 2 0 0 0 0 0 0 9
9 1 1 1 1 1 1 1 1 1 0 0 0 2 2 2 4 7 5 5 15 4 5 5 5 19 10 4 5 5 5 10 4 5 5 4 4 4 4 4 5 5 4 5 5 5 4 5 5 5 4 5 5 5 4 5 5 19 10 4 5 19 10 10 20 5 5 5 19 10 10 20 5 5 5 29 5 5 5 4 5 5 5 5 4 5 5 4 5 15 4 2 2 0 0 0 0 0 0 9
9 1 1 1 1 1 1 1 1 1 1 1 1 2 2 2 4 5 5 5 5 5 5 5 5 5 10 4 5 5 5 5 4 5 5 5 5 4 5 5 5 5 4 5 5 5 4 5 5 5 4 5 5 20 4 5 5 19 10 4 5 5 21 21 5 5 5 5 5 21 21 5 5 5 5 4 5 5 5 4 5 5 5 5 4 19 5 26 5 5 4 2 2 0 0 0 0 0 0 9
9 1 1 1 1 1 1 1 1 1 1 1 1 2 2 2 4 4 4 4 4 4 10 20 5 19 10 4 5 5 5 5 4 3 3 5 5 5 5 5 5 5 4 5 5 5 4 4 5 5 4 5 5 20 4 5 5 19 10 4 5 5 5 5 5 5 5 5 5 5 5 5 5 5 5 4 5 5 5 4 5 5 5 5 4 5 5 4 4 5 4 2 2 0 0 0 0 0 0 9
9 1 1 1 1 1 1 1 1 1 1 1 1 2 2 2 2 2 2 2 2 4 10 5 20 5 10 4 5 5 5 5 4 4 4 4 4 4 4 4 4 4 4 5 5 5 4 5 19 5 4 5 5 20 4 5 5 5 5 4 4 4 4 4 4 4 4 31 31 4 4 4 4 4 4 4 5 5 5 4 5 5 5 5 4 19 5 4 10 12 4 2 2 0 0 0 0 0 0 9
9 1 1 1 1 1 1 1 1 1 1 1 1 2 2 2 2 2 2 2 2 4 10 10 10 10 10 4 5 5 5 5 5 19 19 19 19 19 5 19 19 19 5 5 5 5 4 5 11 11 4 5 5 20 4 5 5 5 5 5 5 5 5 5 5 5 5 5 5 5 5 5 5 5 5 5 5 5 5 4 5 5 5 5 4 19 5 4 4 4 4 2 2 0 0 0 0 0 0 9
9 1 1 1 1 1 1 1 1 1 1 1 1 2 2 2 2 2 2 2 2 4 4 4 4 4 4 4 5 5 5 5 5 5 5 5 5 5 5 5 5 5 5 5 5 5 4 4 4 4 4 5 5 5 4 5 5 5 5 5 5 5 5 5 5 5 5 5 5 5 5 5 5 5 5 5 5 5 5 4 5 5 5 5 4 19 5 4 5 15 4 2 2 0 0 0 0 0 0 9
9 1 1 1 1 1 1 1 1 1 1 1 1 2 2 2 2 2 2 2 2 5 5 5 5 5 5 5 5 5 5 5 5 5 5 5 5 5 5 5 5 5 5 5 5 5 5 5 10 12 5 5 5 5 4 4 4 4 4 4 4 4 4 4 4 25 25 4 4 4 4 4 4 4 4 4 4 4 4 4 5 5 5 5 4 5 5 26 5 5 4 2 2 0 0 0 0 0 0 9
9 1 1 1 1 1 1 1 1 1 1 1 1 2 2 2 2 2 2 2 2 5 5 5 5 5 5 5 5 5 5 5 5 5 5 5 5 5 5 5 5 5 5 5 5 5 5 5 5 5 5 5 5 5 5 5 5 5 5 10 12 5 5 4 5 5 5 5 4 5 5 5 5 5 5 5 5 5 5 5 5 5 5 5 4 5 5 4 4 5 4 2 2 0 0 0 0 0 0 9
9 1 1 1 1 1 1 1 1 1 1 1 1 2 2 2 2 2 2 2 2 5 5 5 5 5 5 5 5 5 5 5 5 5 5 5 5 5 5 5 5 5 5 5 5 5 5 5 5 5 5 5 5 5 5 5 5 5 5 5 5 5 5 29 5 5 5 5 27 5 5 5 5 5 5 5 5 5 5 5 5 5 5 5 29 5 5 4 10 12 4 2 2 0 0 0 0 0 0 9
9 1 1 1 1 1 1 1 1 1 1 1 1 2 2 2 2 2 2 2 2 5 5 5 5 5 5 5 5 5 5 5 5 5 5 5 5 5 5 5 5 5 5 5 5 5 5 5 5 5 5 5 5 5 5 5 5 5 5 5 5 5 5 29 5 5 5 5 27 5 5 5 5 5 5 5 5 5 5 5 5 5 5 5 29 5 5 4 4 4 4 2 2 0 0 0 0 0 0 9
9 1 1 1 1 1 1 1 1 1 1 1 1 2 2 2 2 2 2 2 2 5 5 5 5 5 5 5 5 5 5 5 5 5 5 5 5 5 5 5 5 5 5 5 5 5 5 5 5 5 5 5 5 5 5 5 5 10 12 5 5 5 5 4 5 5 5 5 4 5 5 5 5 10 12 5 5 5 5 5 5 5 5 5 4 5 5 4 5 15 4 2 2 0 0 0 0 0 0 9
9 1 1 1 1 1 1 1 1 1 1 1 1 2 2 2 2 2 2 2 2 5 5 5 5 5 5 5 5 5 5 5 5 5 5 5 5 5 5 5 5 5 5 5 5 5 5 5 5 5 5 5 5 5 4 4 4 4 4 4 4 4 4 4 4 31 31 4 4 4 4 4 4 4 4 4 4 4 4 4 5 5 5 5 4 5 5 26 5 5 4 2 2 0 0 0 0 0 0 9
9 1 1 1 1 1 1 1 1 1 1 1 1 2 2 2 2 2 2 2 2 4 19 5 5 5 20 4 5 5 5 5 5 21 21 21 21 21 21 21 5 5 5 5 21 21 21 21 21 21 21 5 5 5 4 5 11 4 5 11 4 11 5 5 4 5 5 4 5 11 4 5 11 4 5 11 4 5 11 4 5 5 5 5 4 5 5 4 4 5 4 2 2 0 0 0 0 0 0 9
9 1 1 1 1 1 1 1 1 1 1 1 1 2 2 2 2 2 2 2 2 4 19 5 5 5 20 4 11 5 5 5 4 4 4 4 4 4 4 4 4 5 5 4 4 4 4 4 4 4 4 4 5 5 4 5 10 4 5 10 4 10 5 5 29 5 5 27 5 10 4 5 10 4 5 10 4 5 10 4 5 5 5 5 4 5 5 4 10 12 4 2 2 0 0 0 0 0 0 9
9 1 1 1 1 1 1 1 1 1 1 1 1 2 2 2 2 2 2 2 2 4 19 21 21 21 20 4 10 5 5 5 4 10 10 5 5 5 5 5 5 5 5 5 5 5 5 5 5 8 8 4 5 5 4 5 5 4 5 5 4 5 5 5 29 5 5 27 5 5 4 5 5 4 5 5 4 5 5 4 5 5 5 5 4 19 5 4 4 4 4 2 2 0 0 0 0 0 0 9
9 1 1 1 1 1 1 1 1 1 1 1 1 2 2 2 4 4 4 4 4 4 4 4 4 4 4 4 5 5 5 5 4 10 5 5 5 5 5 5 4 5 5 4 5 5 5 5 5 5 5 4 5 5 4 5 5 5 5 5 5 5 5 5 4 5 5 4 5 5 5 5 5 5 5 5 5 5 5 4 5 5 5 5 4 5 5 4 5 15 4 2 2 0 0 0 0 0 0 9
9 1 1 1 1 1 1 1 1 1 1 1 1 2 2 2 4 11 4 13 10 5 5 5 4 5 6 4 5 5 5 5 4 5 5 4 4 4 5 4 4 4 4 4 5 19 10 5 10 20 5 4 5 5 4 3 3 5 5 5 5 5 3 3 4 5 5 4 3 3 5 5 5 5 5 5 5 3 3 4 5 5 5 5 4 19 5 26 5 5 4 2 2 0 0 0 0 0 0 9 
9 1 1 1 1 1 1 1 1 1 0 0 0 2 2 2 4 10 4 4 5 5 4 5 5 5 6 4 5 5 5 5 4 5 5 4 8 5 5 5 5 5 5 5 5 5 10 5 10 5 5 4 4 5 4 4 4 4 25 25 25 4 4 4 4 5 5 4 4 4 4 4 25 25 25 4 4 4 4 4 5 5 5 5 4 5 5 4 4 5 4 2 2 0 0 0 0 0 0 9
9 1 1 1 1 1 1 1 1 1 0 0 0 2 2 2 4 5 5 4 4 4 4 4 4 32 4 4 5 5 5 5 4 5 5 4 8 5 5 5 5 5 5 5 5 19 10 5 10 20 5 4 5 5 5 5 5 5 5 5 5 5 5 5 5 5 5 5 5 5 5 5 5 5 5 5 5 5 5 27 5 5 5 5 29 5 5 4 10 12 4 2 2 0 0 0 0 0 0 9
9 1 1 1 1 1 1 1 1 1 0 0 0 2 2 2 4 5 5 4 5 5 5 5 5 5 5 4 5 5 5 10 4 10 5 4 4 4 5 4 4 4 4 4 5 5 5 5 5 5 5 4 5 5 5 5 5 5 5 5 5 5 5 5 5 5 5 5 5 5 5 5 5 5 5 5 5 5 5 27 5 5 5 5 29 5 5 4 4 4 4 2 2 0 0 0 0 0 0 9
9 1 1 1 1 1 1 1 1 1 0 0 0 2 2 2 4 17 5 28 5 5 5 5 5 5 5 4 5 5 5 14 4 10 20 5 5 5 5 5 4 5 5 4 3 3 5 5 5 3 3 4 4 5 4 4 4 4 31 31 31 4 4 4 4 5 5 4 4 4 4 4 31 31 31 4 4 4 4 4 5 5 5 5 4 5 5 4 5 15 4 2 2 0 0 0 0 0 0 9
9 1 1 1 1 1 1 1 1 1 2 2 2 2 2 2 4 4 4 4 5 5 4 4 4 4 4 4 5 5 5 5 4 4 4 4 4 5 4 4 4 5 5 4 4 4 4 5 5 4 4 4 5 5 4 13 10 5 5 5 5 5 10 12 4 5 5 4 5 8 8 5 5 5 5 5 5 5 5 4 5 5 5 5 4 5 5 26 5 5 4 2 2 0 0 0 0 0 0 9
9 1 1 1 1 1 1 1 1 1 2 2 2 2 2 2 4 17 5 4 5 5 4 5 5 5 5 5 5 5 5 5 5 5 5 5 5 5 5 5 5 5 5 5 5 5 4 5 5 4 5 5 5 5 4 5 5 5 5 5 5 5 5 5 4 5 5 4 5 5 5 5 19 10 5 5 5 5 6 4 5 5 5 5 4 19 5 4 4 5 4 2 2 0 0 0 0 0 0 9
9 1 1 1 1 1 1 1 1 1 2 2 2 2 2 2 4 5 5 28 5 5 5 5 5 5 5 5 5 5 5 5 5 5 5 5 5 5 5 5 5 5 5 5 5 5 4 5 5 4 5 5 5 5 4 4 4 4 5 5 5 4 4 4 4 5 5 4 4 4 4 4 4 4 4 4 5 5 6 4 5 5 5 5 4 19 5 4 10 12 4 2 2 0 0 0 0 0 0 9
9 1 1 1 1 1 1 1 1 1 2 2 2 2 2 2 4 5 4 4 5 5 4 5 5 5 5 5 5 5 5 5 5 5 5 5 5 5 5 5 5 5 5 5 5 5 5 5 5 5 5 5 5 5 4 7 5 5 5 4 5 5 5 5 4 5 5 4 7 5 4 8 8 5 5 4 5 5 5 4 5 5 5 5 4 5 5 4 4 4 4 2 2 0 0 0 0 0 0 9
9 1 1 1 1 1 1 1 1 1 2 2 2 2 2 2 4 13 10 4 5 5 4 5 5 5 5 5 5 5 5 5 5 5 5 5 5 5 5 5 5 5 5 5 5 5 4 5 5 4 5 5 5 5 4 7 5 5 5 4 5 5 5 5 4 5 5 4 7 5 4 5 5 5 5 4 5 5 6 4 5 5 5 5 4 19 5 4 5 15 4 2 2 0 0 0 0 0 0 9
9 1 1 1 1 1 1 1 1 1 2 2 2 4 4 4 4 4 4 4 5 5 4 5 5 5 4 4 4 4 4 4 4 4 4 4 4 5 4 4 4 4 4 4 4 4 4 5 5 4 4 4 4 4 4 4 4 4 5 4 5 19 19 5 4 5 5 4 5 5 4 4 4 5 5 4 5 5 6 4 5 5 5 5 4 19 5 26 5 5 4 2 2 0 0 0 0 0 0 9
9 1 1 1 1 1 1 1 1 1 2 2 2 4 8 8 5 5 4 4 5 5 4 5 5 5 4 7 5 6 4 10 10 5 4 5 5 5 4 8 8 5 4 5 5 5 5 5 5 5 5 5 5 5 5 5 5 5 5 4 10 10 10 10 4 5 5 4 7 5 5 5 5 5 6 4 5 5 5 4 5 5 5 5 4 5 5 4 4 5 4 2 2 0 0 0 0 0 0 9
9 1 1 1 1 1 1 1 1 1 2 2 2 4 5 5 5 5 28 5 5 5 4 5 5 5 4 7 5 6 4 21 21 5 5 5 5 5 5 5 5 5 5 5 5 5 5 5 5 5 5 5 5 5 5 5 5 5 5 4 4 4 4 4 4 5 5 4 7 5 5 5 5 5 6 4 5 5 6 4 5 5 5 5 29 5 5 4 10 12 4 2 2 0 0 0 0 0 0 9
9 1 1 1 1 1 1 1 1 1 2 2 2 4 5 5 4 4 4 5 5 5 27 5 5 5 4 7 5 5 4 4 4 4 4 4 4 4 4 4 4 4 4 5 5 5 5 4 4 4 4 4 4 4 4 5 5 5 5 5 5 5 5 5 4 5 5 4 5 5 5 4 4 4 4 4 5 5 6 4 5 5 5 5 29 5 5 4 4 4 4 2 2 0 0 0 0 0 0 9
9 1 1 1 1 1 1 1 1 1 2 2 2 4 5 5 4 11 4 5 5 5 27 5 5 5 4 5 5 5 5 5 5 5 5 5 5 5 5 5 4 5 5 5 5 5 5 4 10 8 8 8 8 5 5 5 5 5 5 5 5 5 5 5 5 5 5 4 7 5 5 5 5 5 5 5 5 5 5 4 5 5 5 5 4 5 5 4 5 15 4 2 2 0 0 0 0 0 0 9
9 1 1 1 1 1 1 1 1 1 2 2 2 4 5 5 5 10 4 5 5 5 4 5 5 5 4 5 5 5 5 5 5 5 5 5 5 5 5 5 5 5 5 5 5 5 5 4 21 5 5 5 5 5 4 5 5 5 5 5 5 5 5 5 4 5 5 4 7 5 5 3 3 5 3 3 5 3 3 4 5 5 5 5 4 5 5 26 5 5 4 2 2 0 0 0 0 0 0 9
9 1 1 1 1 1 1 1 1 1 2 2 2 4 4 4 4 4 4 5 5 5 4 5 5 5 4 4 4 4 4 4 4 4 4 4 4 5 4 4 4 4 4 4 5 5 4 4 4 4 4 4 4 4 4 4 4 4 4 4 4 4 4 4 4 5 5 4 4 4 4 4 4 4 4 4 4 4 4 4 5 5 5 5 4 5 5 4 4 5 4 2 2 0 0 0 0 0 0 9
9 1 1 1 1 1 1 1 1 1 2 2 2 4 8 8 5 5 4 5 5 5 4 5 5 5 5 5 5 5 5 5 5 5 5 5 5 5 5 5 5 5 5 5 5 5 5 5 5 5 5 5 5 5 5 5 5 5 5 5 5 5 5 5 5 5 5 5 5 5 5 5 5 5 5 5 5 5 5 5 5 5 5 5 4 19 5 4 10 12 4 2 2 0 0 0 0 0 0 9
9 1 1 1 1 1 1 1 1 1 2 2 2 4 5 5 5 5 28 5 5 5 4 5 5 5 5 5 5 5 5 5 5 5 5 5 5 5 5 5 5 5 5 5 5 5 5 5 5 5 5 5 5 5 5 5 5 5 5 5 5 5 5 5 5 5 5 5 5 5 5 5 5 5 5 5 5 5 5 5 5 5 5 5 4 5 5 4 4 4 4 2 2 0 0 0 0 0 0 9
9 1 1 1 1 1 1 1 1 1 2 2 2 4 5 5 4 4 4 5 5 5 4 5 5 5 5 5 5 5 5 5 5 5 5 5 5 5 5 5 5 5 5 5 5 5 5 5 5 5 5 5 5 5 5 5 5 5 5 5 5 5 5 5 5 5 5 5 5 5 5 5 5 5 5 5 5 5 5 5 5 5 5 5 4 19 5 4 5 15 4 2 2 0 0 0 0 0 0 9
9 1 1 1 1 1 1 1 1 1 2 2 2 4 5 5 4 11 4 5 5 5 4 4 4 4 4 4 4 4 4 4 5 4 4 4 4 4 4 4 4 4 4 4 4 4 4 4 31 31 4 4 4 4 4 4 4 4 4 4 4 4 4 4 4 31 31 4 4 4 4 4 4 4 4 4 4 4 5 4 4 4 4 4 4 5 5 26 5 5 4 2 2 0 0 0 0 0 0 9
9 1 1 1 1 1 1 1 1 1 2 2 2 4 5 5 5 10 4 5 5 5 5 5 5 5 5 5 5 5 5 5 5 5 5 5 5 5 5 5 5 5 5 5 5 5 5 5 5 5 5 5 5 5 5 5 5 5 5 5 5 5 5 5 5 5 5 5 5 5 5 5 5 5 5 5 5 5 5 5 5 5 5 5 5 5 5 4 4 5 4 2 2 0 0 0 0 0 0 9
9 1 1 1 1 1 1 1 1 1 2 2 2 4 4 4 4 4 4 5 5 5 5 5 5 5 5 5 5 5 5 5 5 5 5 5 5 5 5 5 5 5 5 5 5 5 5 5 5 5 5 5 5 5 5 5 5 5 5 5 5 5 5 5 5 5 5 5 5 5 5 5 5 5 5 5 5 5 5 5 5 5 5 5 5 5 5 4 10 12 4 2 2 0 0 0 0 0 0 9
9 1 1 1 1 1 1 1 1 1 2 2 2 4 11 5 5 18 4 5 4 4 4 4 32 4 4 4 4 32 4 4 4 4 32 4 4 4 4 32 4 4 4 4 32 4 4 4 4 32 4 4 4 4 32 4 4 4 4 32 4 4 4 4 32 4 4 4 4 32 4 4 4 4 32 4 4 4 4 32 4 4 4 4 4 32 4 4 4 4 4 2 2 0 0 0 0 0 0 9
9 1 1 1 1 1 1 1 1 1 2 2 2 4 10 5 4 4 4 5 18 4 10 4 5 18 4 10 4 5 18 4 10 4 5 18 4 10 4 5 18 4 10 4 5 18 4 10 4 5 18 4 10 4 5 18 4 10 4 5 18 4 10 4 5 18 4 10 4 5 18 4 10 4 5 18 4 10 4 5 5 4 7 5 4 5 5 5 5 10 4 2 2 0 0 0 0 0 0 9
9 1 1 1 1 1 1 1 1 1 2 2 2 4 5 5 5 5 5 5 5 4 14 5 5 5 4 14 5 5 5 4 14 5 5 5 4 14 5 5 5 4 14 5 5 5 4 14 5 5 5 4 14 5 5 5 4 14 5 5 5 4 14 5 5 5 4 14 5 5 5 4 14 5 5 5 4 14 5 5 18 4 7 5 5 5 5 4 5 14 4 2 2 0 0 0 0 0 0 9
9 1 1 1 1 1 1 1 1 1 2 2 2 4 4 4 4 4 4 4 4 4 4 4 4 4 4 4 4 4 4 4 4 4 4 4 4 4 4 4 4 4 4 4 4 4 4 4 4 4 4 4 4 4 4 4 4 4 4 4 4 4 4 4 4 4 4 4 4 4 4 4 4 4 4 4 4 4 4 4 4 4 4 4 4 4 4 4 4 4 4 2 2 0 0 0 0 0 0 9
9 1 1 1 1 1 1 1 1 1 2 2 2 2 2 2 2 2 2 2 2 2 2 2 2 2 2 2 2 2 2 2 2 2 2 2 2 2 2 2 2 2 2 2 2 2 2 2 2 2 2 2 2 2 2 2 2 2 2 2 2 2 2 2 2 2 2 2 2 2 2 2 2 2 2 2 2 2 2 2 2 2 2 2 2 2 2 2 2 2 2 2 2 0 0 0 0 0 0 9
9 9 9 9 9 9 9 9 9 9 9 9 9 9 9 9 9 9 9 9 9 9 9 9 9 9 9 9 9 9 9 9 9 9 9 9 9 9 9 9 9 9 9 9 9 9 9 9 9 9 9 9 9 9 9 9 9 9 9 9 9 9 9 9 9 9 9 9 9 9 9 9 9 9 9 9 9 9 9 9 9 9 9 9 9 9 9 9 9 9 9 9 9 9 9 9 9 9 9 9 
